jbray = Jason Bray <jbray@heuristics.net>
mfeimster = Mike Feimster <mfeimster@heuristics.net>
callen = Calvin Allen <callen@heuristics.net>
blytle = Brian Lytle <blytle@heuristics.net>
sreed = Scott Reed <sreed@heuristics.net>
sjohnson = Seth Petry-Johnson <sjohnson@heuristics.net>
snicholson = Sara Nicholson <snicholson@heuristics.net>
cmoore = Chris Moore <cmoore@heuristics.net>
gpfeiffer = Glen Pfeiffer <gpfeiffer@heuristics.net>
sross = Steve Ross <sross@heuristics.net>
bphipps = Brad Phipps <bphipps@heuristics.net>
release_user = release_user <release_user>
instance_manager = instance_manager <instance_manager>
rdavid = Ryan David <rdavid@heuristics.net>
eharman = Ethan Harman <eharman@heuristics.net>
radach = Robert Adach <radach@heuristics.net>
mbowman = Mike Bowman <mbowman@heuristics.net>
trust = Tom Rust <trust@heuristics.net>
mgroves = Matt Groves <mgroves@heuristics.net>
jhammond = Jonathan Hammond <jhammond@heuristics.net>
pzielinski = Piotr Zielinski <pzielinski@heuristics.net>
jbibb = Josh Bibb <jbibb@heuristics.net>
jblankenship = Jerrel Blankenship <jblankenship@heuristics.net>
swallace = Shawn Wallace <swallace@heuristics.net>
cbutcher = Christopher Butcher <cbutcher@heuristics.net>
cwaterman = cwaterman <cwaterman@heuristics.net>
adavila = adavila <adavila@heuristics.net>
mrinaldi = mrinaldi <mrinaldi@heuristics.net>
kchew = kchew <kchew@heuristics.net>
aneal = Ali Neal <aneal@heuristics.net>
akissel = April Kissel <akissel@heuristics.net>
mbucell = Mallory Bucell <mbucell@heuristics.net>